..........
..........
.b........
..........
.a.....c..
....d.....
.a.....a..